WWWWWWWWWWWWWWWWWWWW
W  E  CC  W    C   W
WWWWWWW  WW   WWWW W
WCCWCCW  W  WWWCCW W
W  W  W  W  C W  W W
W C      WWW  W  WCW
WWWWWWW    W     W W
W     WWWW W   WWW W
W  W  W CW WWW C W W
W  W  W   E      W W
W  W  WWWWWWWWW  W W
W  W    E  C WW  W W
W  WWWWWW     W  WSW
W      FWWW    C WWW
WWWWWWWWWWWWWWWWWWWW

